# for wall tex NO WE SO EA  || D S (doors) || 0123 for wall pics
# F C 
# sprites 4 - 9
# 5 is for lights
# M sounds comes with the sp number or 1 for the main music
# G gun  tex 10

#D ./texture/barrel.xpm

NO ./texture/bluestone.xpm
      
    
     
 C ./texture/MineShaft00.XPM
 
 WE ./texture/mossy.xpm
  
SO ./texture/old_stones.xpm
 
  
F ./texture/eagle.xpm
 
 
EA ./texture/redbrick.xpm

3 |8 ./texture/wor.xpm | 5 ./texture/lamp.xpm|   2 ./texture/eagle.xpm 

3 | 6   ./texture/barrel.xpm | 7 ./texture/barrel.xpm | 9 ./texture/table.xpm

3 | 1 ./texture/WoodenWallWithPoster0.xpm | 3 ./texture/WoodenWallWithStand0.xpm | 4 ./texture/WoodenWallWithStand1.xpm 
 
        R 1920 1080


         1112111211121112111        11121121112111
       111800000000000000001        108000080000811121211
111111110000000900060000010111211211100000050000000005001
10N000500000005000000005000000050000000000060000000011211
11111111000000000000000000001112112110000000000900001
    1000000000000010000600001       18000090500100002
112110000006000000s0000000001112112110000000000100001
18000000000000000010000000000000800000001111211100011
1121110000000000000000000000000000000000200000000001
     10000005000000600000500600005000000110050000011
     18000000000000000000000009000000001110000012111
     11121211000000050000000000000000000011110011
            200000000006000000005009000000001011
            18000080000000000000800000000000s01
            11211211121112111211121112111211111


