 # for wall tex NO WE SO EA  || D S (doors) || 0123 for wall pics
# F C 
 # sprites 4 - 9
   # 5 is for lights
    # M sounds comes with the sp number or 1 for the main music
  # G gun  tex 10
 #D ./texture/barrel.xpm
    #S      ./texture/table.xpm
2 | 3 ./texture/barrel.xpm  | 4  ./texture/table.xpm
  NO  ./texture/bluestone.xpm
   C    255 , 22 , 255
    WE  ./texture/bluestone.xpm
  SO  ./texture/bluestone.xpm
 # F   11 , 122,22
 F ./texture/bluestone.xpm
     EA  ./texture/bluestone.xpm

# 4 | 8  ./texture/barrel.xpm |  5  ./texture/barrel.xpm|   2  ./texture/barrel.xpm | 7  ./texture/barrel.xpm
# 3 | 6   ./texture/barrel.xpm | 7  ./texture/barrel.xpm |  9  ./texture/barrel.xpm
# 3 | 1  ./texture/barrel.xpm | 3   ./texture/barrel.xpm |  4  ./texture/barrel.xpm
  
   R    1076   1000

11111111111111111111
10000030040000000001
1000000300N030000001
10000000000000000001
11111111111111111111


