 # for wall tex NO WE SO EA  || D S (doors) || 0123 for wall pics
# F C 
 # sprites 4 - 9
   # 5 is for lights
    # M sounds comes with the sp number or 1 for the main music
  # G gun  tex 10
 #D ./texture/barrel.xpm
NO ./texture/barrel.xpm
C ./texture/barrel.XPM
WE ./texture/barrel.xpm
SO ./texture/barrel.xpm
F ./texture/barrel.xpm
EA ./texture/barrel.xpm
#S ./texture/barrel.xpm
4 | 8 ./texture/barrel.xpm | 5 ./texture/barrel.xpm|   2 ./texture/barrel.xpm | 7 ./texture/barrel.xpm
3 | 6   ./texture/barrel.xpm | 7 ./texture/barrel.xpm | 9 ./texture/barrel.xpm
3 | 1 ./texture/barrel.xpm | 3 ./texture/barrel.xpm | 4 ./texture/barrel.xpm
R 1920 1080
1111111111111111111
1000000000000000001
10000000000000000011
10000000000000000001
11111111111111111111