# for wall tex NO WE SO EA  || D S (doors) || 0123 for wall pics
# F C 
# sprites 4 - 9
# 5 is for lights
# M sounds comes with the sp number or 1 for the main music
# G gun  tex 10

#D ./texture/barrel.xpm

NO ./texture/bluestone.xpm
      
    
     
 C ./texture/MineShaft00.XPM
 
 WE ./texture/mossy.xpm
  
SO ./texture/old_stones.xpm
 
  
F ./texture/mossy.xpm
 
 
EA ./texture/redbrick.xpm

4 |8 ./texture/wor.xpm | 5 ./texture/lamp.xpm|   2 ./texture/eagle.xpm | 7 ./texture/barrel.xpm

3 | 6   ./texture/barrel.xpm | 7 ./texture/barrel.xpm | 9 ./texture/table.xpm

3 | 1 ./texture/WoodenWallWithPoster0.xpm | 3 ./texture/WoodenWallWithStand0.xpm | 4 ./texture/WoodenWallWithStand1.xpm 
 

        R 1920 1080


                                                       1111111111111111111111111112111121111111111
                                                       10000000000000000000000000000000000000000011
                                                       100000000000000000000080000000000000000000011
                                                       1000000000000000000000000000000000000000000011
             1111111  111111111111111111111            10000000000000000000000000000000300000000000011
          1111108001  100011110000000000001            100000000000000000000000000000000000000000000011
       111110000000111100000000012111111101            1000000000000000000000000000000000000000000000021
 11111111000000500000000005000000011    101            10000000000005000000008000000000000000000000000011
 10000000030000000011110000020000111   11011111111     100000000000000000000000000000000000000000000000011
 1100500000000000001  10000000000001   11000000001     1000000000000000000000000000000000000000000000000021
 1111111111111111111  11111100111111   11111111101     10000000000000000000000000000000000000000000000000011
                           10001               101     100000000000000000000000000000000000000000000000000011
 11111111111111111     111110001111111111111   101111  1000000000000000000000000000200020000000000000000000021
 11000000000000011    1100000000000000000001   1000011110000000000000500000000000002000000000000000000000000011
 10000003000000001    1000000000000000000001   1100000000000000000000000800000E000020000000000000000000000000011
 11000000000000011    1100000000000111110001   1000001 10000000000000000000000005000000000000000000000000000011
 1000000000000001      1000000000001   10001   1000001 1000000000000000000000000000000000000000000000000000021
 11100000000000011111111000000000001   10001   11000011100000000000000000000000000000000000000000000000000011
  1111000000000000001000000000000001   10001  11100000000000000000000000000000050000000000000000000000000021
  1100000000000000020000000001111111   11111  1000111111000000000000000000000000000000000000000000000000011
  11111000000000000000000000000001            10001    100000000000000000000000000000000000000000000000021
111000000000000000000005000001111111111111111110001    10000000000000000000000000000000000000000000000011
111111000000000000000000020000000000000000000000001    1000000000000000000000000000000000000000000000011
    11111100000000000000000011111111111111111000001    100000000000000000000000000000000000000000000011
        1111110000000000111111            111111111    10000000000000000000000000000000000000000000011
            11111111111111                             1000000000000000000000000000000000000000000011
                                                       100000000000000000000000000000000000000000011
                                                       111111100111121112111212111121112111211121211
                                                             1111


