R 1920 1080
NO ./texture/bluestone.xpm
WE ./texture/colorstone.xpm
SO ./texture/old_stones.xpm
EA ./texture/redbrick.xpm


11111111111111111111111111111
10000000001100000000000004001
10110000011100000000200000001
10010000000000000000200000101
10110000011100000000000000001
10000000001100000110000000001
11110111111111011100000000001
11110111111111011100000000001
1100000011010101110000W000001
10000000000000001100000000001
10000000000000001100000000101
11000000110101011111011110001
11110111111101011111011110001
11111111111111111111111111111













