R  1920  1080
        1111111111111111111111111
        1000002000110000000000001
        101100300111000E002000001
        1001000000000000002000001
111111111011000001110000002000001
100000000011000001110111111111111
11110111111111011100000010001
11110111111111011101010000201
11000000110101011100000010201
10002000000000001100000010001
10000000000000001101010010001
1100000111010101111101111000111
11110111 1110101 101111010001
11111111 1111111 111111111111