 # for wall tex NO WE SO EA  || D S (doors) || 0123 for wall pics
# F C 
 # sprites 4 - 9
   # 5 is for lights
    # M sounds comes with the sp number or 1 for the main music
  # G gun  tex 10
 #D ./texture/barrel.xpm
    #S      ./texture/table.xpm
4 | 3 ./texture/wor.xpm  | 4  ./texture/table.xpm | 2 ./texture/eagle.xpm  | 5 ./texture/lamp.xpm 
  WE  ./texture/bluestone.xpm
   C    255 , 22 , 255
    NO  ./texture/colorstone.xpm
  SO  ./texture/bluestone.xpm
 # F   11 , 122,22
 F ./texture/bluestone.xpm
     EA  ./texture/bluestone.xpm
#EA  ./texture/bluestone.xpm
# 4 | 8  ./texture/barrel.xpm |  5  ./texture/barrel.xpm|   2  ./texture/barrel.xpm | 7  ./texture/barrel.xpm
# 3 | 6   ./texture/barrel.xpm | 7  ./texture/barrel.xpm |  9  ./texture/barrel.xpm
# 3 | 1  ./texture/barrel.xpm | 3   ./texture/barrel.xpm |  4  ./texture/barrel.xpm

   R    1500   000000000000000000001100



11111111111111111111111111111111111                    1111111
    110000200020011000000000000000211111111111       11111  11111111
    11000021000002011100000020000010001110001111111111    11 11    11111111
     111100200110000000110000010001111111111111          111     1111   11
     1111111111110011111111111111111111
                1001
        11111111100111111111111111111
        10000000011100000000000010011              111        111    111
1111111111100000000011000001110111101    1111      111          111111
1111111000000111s111110111000000100011111111      11011         111
1100000011110111s1111101110101001000000000011      1111         11
 111111003000000s10201011100000000011111100011     11111111111111
      112000s000N0000000ss000000100011111111011111111
        10000040500000001101010010001111111101111111
        1111111111s1s1111111111111111111111111111111111
        1111111111s1s1111111111111111111111111111111111111
111111111100000012020101111101111000000000100001111111
110111000000111111000011111110101111001100000111
1111111111100111111111111111111111111000001111
         11111                      11011111
         11111          111         1111 
         11111         11            11
            11        11              1
             11111111111            11

