WE  ./texture/bluestone.xpm
   C    255 , 22 ,255
    NO  ./texture/colorstone.xpm
  SO  ./texture/bluestone.xpm
    R    1555 1555
     F   11 , 122,22
     S      ./texture/table.xpm

 EA  ./texture/bluestone.xpm

11111111111111111111111111111
100000200011000000000000000011111111111111
101100000111000000200000100000000000000001
100100000000001111100000100000001111111101
101100001111001   100000100000001      101
100020001 11001111110111100000001111111101
100000001 11110111000000100011111000N00001
111000001111110111010100100011111111111111
11110000011011011100000010001
10112020020000000100000010001
10100000000000002101010010001
111111111111111111111111111111
11110000000111110111011110001
11111111111110101111101111001
11111111111111111111111111111